.............
.............
...B.B.B.B...
...B.D.D.B...
.....E.E.....
.BB.......BB.
.B....S....B.
P.....B.....P
.B.........B.
.BB.......BB.
.....E.E.....
...B.D.B.B...
...B.B.B.B...
.............
.............