.B...B.....B.
.B.BBBBBBB.B.
...B.....B.B.
.BBB.SBB.B.E.
.....B...B...
BBBBBB.BBD.B.
......PB.B.B.
.BBSBBBB.E.BB
.B.....B.....
.BBBBB.B.BBB.
.B.....B.B...
.B.BBBBD.BBBB
...B...B.....
BB.S.D.BBBBE.
.....B.......