.B.B.........
.B.B.BBBBEBB.
.B...B.......
.B.EBB.SBBBBB
.B.B...B.....
.S.BBDBB.EBD.
.....BP..B...
BBBB.B.BBB.SB
.B.B.B.B.B.B.
.B.B.B.B.E.B.
.B.B.B...B...
.B.B.BBB.BBBB
...B...B.B...
.B.DBB.B.BBE.
.B...........