.......B.....
.EBBBS.BBBBB.
.....B.B.....
BBBB.D.E.BBBB
...B.B.......
.B.S.DBBBBBD.
.B...BPB.....
.BBBBB.B.BBBB
.B.....B.....
.E.BBB.BBBBB.
.B.B.B.B...B.
BB.B.B.B.B.S.
...B...B.B.B.
.BBB.BBB.B.B.
.B.......B...